1111000001000000100000001000000010000000100000001000000010000000100000001000000010000000011
1000100333330001003333300001003333301003333300010033333000100333300001003333301003333300111
1033000555555001005555500010055555001005555500010055555000100555500001005555500010055553311
1055004444444001004444400010044444001004444400010044444000100444400001004444400010044445511
1044000000000001000000000010000000001000000000010000000000100000000001000000000010000004411
1033003333330001003333300001003333301003333300010033333000100333300001003333301003333302211
1010011111111001001111100010011111001001111100010011111000100111100001001111100010011110111
1022200000000001000000000010000000001000000000010000000000100000000001000000000010000002211
1044404444444001004444400010044444001004444400010044444000100444400001004444400010044444411
1055500000000001000000000010000000001000000000010000000000100000000001000000000010000005511
1033002222222001002222200010022222001002222200010022222000100222200001002222200010022223311
1055005555555001005555500010055555001005555500010055555000100555500001005555500010055555511
1044004444444001004444400010044444001004444400010044444000100444400001004444400010044444411
1000100000000001000000000010000000001000000000010000000000100000000001000000000010000000011
1022203333333001003333300010033333001003333300010033333000100333300001003333301003333302211
1044405555555001005555500010055555001005555500010055555000100555500001005555500010055554411
1055504444444001004444400010044444001004444400010044444000100444400001004444400010044445511
1033000000000001000000000010000000001000000000010000000000100000000001000000000010000003311
1055502222222001002222200010022222001002222200010022222000100222200001002222200010022225511
1044403333333001003333300010033333001003333300010033333000100333300001003333301003333304411
1000105555555001005555500010055555001005555500010055555000100555500001005555500010055550011
1022204444444001004444400010044444001004444400010044444000100444400001004444400010044442211
1044400000000001000000000010000000001000000000010000000000100000000001000000000010000004411
1055503333333001003333300010033333001003333300010033333000100333300001003333301003333305511
1033005555555001005555500010055555001005555500010055555000100555500001005555500010055553311
1010011111111001001111100010011111001001111100010011111000100111100001001111100010011110111
1022204444444001004444400010044444001004444400010044444000100444400001004444400010044442211
1044402222222001002222200010022222001002222200010022222000100222200001002222200010022224411
1055503333333001003333300010033333001003333300010033333000100333300001003333301003333305511
1033000000000001000000000010000000001000000000010000000000100000000001000000000010000003311
1055505555555001005555500010055555001005555500010055555000100555500001005555500010055555511
1044404444444001004444400010044444001004444400010044444000100444400001004444400010044444411
1000102222222001002222200010022222001002222200010022222000100222200001002222200010022220011
1022203333333001003333300010033333001003333300010033333000100333300001003333301003333302211
1044400000000001000000000010000000001000000000010000000000100000000001000000000010000004411
1055505555555001005555500010055555001005555500010055555000100555500001005555500010055555511
1033004444444001004444400010044444001004444400010044444000100444400001004444400010044443311
1000101111111001001111100010011111001001111100010011111000100111100001001111100010011110011
1022200000000001000000000010000000001000000000010000000000100000000001000000000010000002211
1044403333333001003333300010033333001003333300010033333000100333300001003333301003333304411
1055505555555001005555500010055555001005555500010055555000100555500001005555500010055555511
1033000000000001000000000010000000001000000000010000000000100000000001000000000010000003311
1000105555555001005555500010055555001005555500010055555000100555500001005555500010055550011
1022204444444001004444400010044444001004444400010044444000100444400001004444400010044442211
1044402222222001002222200010022222001002222200010022222000100222200001002222200010022224411
1055503333333001003333300010033333001003333300010033333000100333300001003333301003333305511
1033005555555001005555500010055555001005555500010055555000100555500001005555500010055553311
1010011111111001001111100010011111001001111100010011111000100111100001001111100010011110111
1022204444444001004444400010044444001004444400010044444000100444400001004444400010044442211
1044403333333001003333300010033333001003333300010033333000100333300001003333301003333304411
1055505555555001005555500010055555001005555500010055555000100555500001005555500010055555511
